Time,Team,Operation,BuyVolume,SellVolume,EtfPosition,FuturePosition,EtfPrice,FuturePrice,TotalFees,AccountBalance,ProfitOrLoss,Status
2e-06,TraderOne,Tick,0,0,0,0,,,0,0,0,OK
0.271171,TraderOne,Tick,0,0,0,0,,,0,0,0,OK
0.486713,TraderOne,Tick,0,0,0,0,,,0,0,0,OK
0.717072,TraderOne,Tick,0,0,0,0,,,0,0,0,OK
1.007786,TraderOne,Tick,0,10,-10,10,147600,147100,-147,147,-1853,OK
1.253668,TraderOne,Tick,1,10,-9,9,147200,147100,-162,62,-838,OK
1.478394,TraderOne,Tick,1,10,-9,9,147200,147100,-162,62,-838,OK
1.798477,TraderOne,Tick,1,10,-9,9,147200,147100,-162,62,-838,OK
1.987967,TraderOne,Tick,1,10,-9,9,147200,147100,-162,62,-838,OK
2.296868,TraderOne,Tick,1,10,-9,9,147200,146900,-162,62,-1738,OK
2.485983,TraderOne,Tick,1,10,-9,9,147200,146900,-162,62,-1738,OK
2.762409,TraderOne,Tick,11,10,1,-1,146400,146900,-309,-1791,-1991,OK
3.040989,TraderOne,Tick,11,10,1,-1,146400,146900,-309,-1791,-1991,OK
3.22966,TraderOne,Tick,11,10,1,-1,146400,146900,-309,-1791,-1991,OK
3.535068,TraderOne,Tick,11,20,-9,9,147500,146900,-456,-1644,-3444,OK
3.775045,TraderOne,Tick,21,20,1,-1,146300,146900,-603,-1497,-1697,OK
4.009279,TraderOne,Tick,21,20,1,-1,146300,146900,-603,-1497,-1697,OK
4.251983,TraderOne,Tick,21,20,1,-1,146300,146900,-603,-1497,-1697,OK
4.501162,TraderOne,Tick,31,20,11,-11,146300,146900,-750,-1350,-3550,OK
4.7451,TraderOne,Tick,31,20,11,-11,146300,146900,-750,-1350,-3550,OK
4.955581,TraderOne,Tick,31,20,11,-11,146300,146900,-750,-1350,-3550,OK
5.231025,TraderOne,Tick,31,20,11,-11,146300,146800,-750,-1350,-3550,OK
5.466835,TraderOne,Tick,31,20,11,-11,146300,146800,-750,-1350,-3550,OK
5.739395,TraderOne,Tick,31,20,11,-11,146300,146800,-750,-1350,-3550,OK
6.015471,TraderOne,Tick,31,30,1,-1,147000,146800,-456,-1644,-1444,OK
6.231743,TraderOne,Tick,31,40,-9,9,147000,146800,-162,-938,-2738,OK
6.495044,TraderOne,Tick,31,50,-19,19,147000,146800,132,1768,-2032,OK
6.74857,TraderOne,Tick,31,60,-29,29,147200,146700,426,4474,-1326,OK
7.01068,TraderOne,Tick,31,60,-29,29,147200,146900,426,4474,-1326,OK
7.230433,TraderOne,Tick,31,60,-29,29,147200,146900,426,4474,-1326,OK
7.544833,TraderOne,Tick,31,60,-29,29,147200,146900,426,4474,-1326,OK
7.716878,TraderOne,Tick,31,60,-29,29,147200,146900,426,4474,-1326,OK
8.007983,TraderOne,Tick,31,60,-29,29,147200,146900,426,4474,-1326,OK
8.243359,TraderOne,Tick,31,60,-29,29,147000,146900,426,4474,1574,OK
8.510892,TraderOne,Tick,31,60,-29,29,147000,146900,426,4474,1574,OK
8.738638,TraderOne,Tick,31,60,-29,29,147000,146900,426,4474,1574,OK
9.018409,TraderOne,Tick,41,60,-19,19,146700,146900,279,2621,6421,OK
9.280328,TraderOne,Tick,51,60,-9,9,146400,146900,572,5328,7128,OK
9.521496,TraderOne,Tick,61,60,1,-1,146400,146900,865,8035,7835,OK
9.798555,TraderOne,Tick,71,60,11,-11,146400,146900,1158,9742,7542,OK
9.976608,TraderOne,Tick,81,60,21,-21,146400,146900,1451,11449,7249,OK
10.263817,TraderOne,Tick,91,60,31,-31,146400,146900,1744,13156,6956,OK
10.490758,TraderOne,Tick,101,60,41,-41,146400,146900,2037,16863,8663,OK
10.715164,TraderOne,Tick,111,60,51,-51,146400,147000,2330,21570,11370,OK
11.017127,TraderOne,Tick,111,70,41,-41,147300,147000,2183,16717,24917,OK
11.268838,TraderOne,Tick,111,70,41,-41,147300,147000,2183,16717,24917,OK
11.524892,TraderOne,Tick,111,70,41,-41,147300,147000,2183,16717,24917,OK
11.720887,TraderOne,Tick,111,70,41,-41,147300,147200,2183,16717,20817,OK
12.02216,TraderOne,Tick,111,80,31,-31,147400,147200,2036,13864,20064,OK
12.228598,TraderOne,Tick,111,80,31,-31,147400,147200,2036,13864,20064,OK
12.509511,TraderOne,Tick,111,80,31,-31,147400,147200,2036,13864,20064,OK
12.720847,TraderOne,Tick,111,80,31,-31,147400,147200,2036,13864,20064,OK
13.019037,TraderOne,Tick,111,80,31,-31,147400,147200,2036,13864,20064,OK
13.297536,TraderOne,Tick,111,80,31,-31,146600,147200,2036,13864,7664,OK
13.524028,TraderOne,Tick,111,80,31,-31,146600,147200,2036,13864,7664,OK
13.777134,TraderOne,Tick,111,80,31,-31,146600,147200,2036,13864,7664,OK
14.026789,TraderOne,Tick,111,80,31,-31,146600,147200,2036,13864,7664,OK
14.27508,TraderOne,Tick,111,80,31,-31,146600,147200,2036,13864,7664,OK
14.506094,TraderOne,Tick,111,80,31,-31,146600,147200,2036,13864,7664,OK
14.724852,TraderOne,Tick,111,80,31,-31,146600,147200,2036,13864,7664,OK
14.95504,TraderOne,Tick,111,80,31,-31,146600,147200,2036,13864,7664,OK
15.212658,TraderOne,Tick,111,80,31,-31,146600,147200,2036,13864,7664,OK
15.501568,TraderOne,Tick,111,90,21,-21,146900,146800,1889,11011,13111,OK
15.709452,TraderOne,Tick,111,90,21,-21,146900,146800,1889,11011,13111,OK
15.964929,TraderOne,Tick,111,100,11,-11,146900,146900,1742,7158,7158,OK
16.295652,TraderOne,Tick,111,100,11,-11,146900,146900,1742,7158,7158,OK
16.454072,TraderOne,Tick,111,100,11,-11,146900,146900,1742,7158,7158,OK
16.734455,TraderOne,Tick,111,100,11,-11,146900,146900,1742,7158,7158,OK
16.985992,TraderOne,Tick,111,100,11,-11,146900,146900,1742,7158,7158,OK
17.294845,TraderOne,Tick,111,100,11,-11,146900,146900,1742,7158,7158,OK
17.454226,TraderOne,Tick,111,100,11,-11,146900,146900,1742,7158,7158,OK
17.776353,TraderOne,Tick,121,100,21,-21,146900,146900,2036,7864,7864,OK
18.011395,TraderOne,Tick,131,100,31,-31,146600,146900,1889,10011,3811,OK
18.258944,TraderOne,Tick,131,100,31,-31,146600,146900,1889,10011,3811,OK
18.477137,TraderOne,Tick,131,100,31,-31,146600,147100,1889,10011,3811,OK
18.756917,TraderOne,Tick,131,100,31,-31,146600,147100,1889,10011,3811,OK
18.976839,TraderOne,Tick,131,100,31,-31,146600,147100,1889,10011,3811,OK
19.202569,TraderOne,Tick,131,100,31,-31,146600,147100,1889,10011,3811,OK
19.456196,TraderOne,Tick,131,100,31,-31,146600,147200,1889,10011,3811,OK
19.711884,TraderOne,Tick,131,100,31,-31,146600,147200,1889,10011,3811,OK
20.033297,TraderOne,Tick,131,100,31,-31,146600,147200,1889,10011,3811,OK
20.254289,TraderOne,Tick,141,100,41,-41,146900,147200,2183,12717,4517,OK
20.522345,TraderOne,Tick,151,100,51,-51,146900,147900,2477,17423,7223,OK
20.773917,TraderOne,Tick,161,110,51,-51,147500,147900,2624,20276,10076,OK
21.030644,TraderOne,Tick,161,116,45,-45,147600,147900,2801,18299,9299,OK
21.2672,TraderOne,Tick,161,116,45,-45,147600,147900,2801,18299,9299,OK
21.474896,TraderOne,Tick,161,116,45,-45,147600,147900,2801,18299,9299,OK
21.787146,TraderOne,Tick,161,116,45,-45,147600,147900,2801,18299,9299,OK
21.961625,TraderOne,Tick,161,116,45,-45,147600,148000,2801,18299,9299,OK
22.21292,TraderOne,Tick,161,116,45,-45,147600,148000,2801,18299,9299,OK
22.453054,TraderOne,Tick,161,116,45,-45,147600,148100,2801,18299,9299,OK
22.707143,TraderOne,Tick,161,116,45,-45,147600,148200,2801,18299,9299,OK
23.028869,TraderOne,Tick,171,116,55,-55,147700,148000,3096,22004,11004,OK
23.246827,TraderOne,Tick,171,116,55,-55,147700,148000,3096,22004,11004,OK
23.526373,TraderOne,Tick,171,126,45,-45,147400,147700,3391,18709,9709,OK
23.78247,TraderOne,Tick,171,126,45,-45,147400,147700,3391,18709,9709,OK
23.955453,TraderOne,Tick,171,126,45,-45,147400,147700,3391,18709,9709,OK
24.23424,TraderOne,Tick,171,126,45,-45,147400,147700,3391,18709,9709,OK
24.541542,TraderOne,Tick,181,126,55,-55,147400,147700,3686,22414,11414,OK
24.762468,TraderOne,Tick,181,126,55,-55,147400,148100,3686,22414,11414,OK
24.959298,TraderOne,Tick,181,126,55,-55,147400,148100,3686,22414,11414,OK
25.294199,TraderOne,Tick,191,126,65,-65,147700,148200,3981,27119,14119,OK
25.478486,TraderOne,Tick,191,136,55,-55,147600,147900,4276,20824,9824,OK
25.713258,TraderOne,Tick,191,136,55,-55,147700,147900,4276,20824,9824,OK
25.973819,TraderOne,Tick,191,136,55,-55,147700,147900,4276,20824,9824,OK
26.285399,TraderOne,Tick,191,136,55,-55,147700,147900,4276,20824,9824,OK
26.497948,TraderOne,Tick,191,146,45,-45,147400,147900,4571,13529,4529,OK
26.777697,TraderOne,Tick,191,146,45,-45,147400,147900,4571,13529,4529,OK
27.048113,TraderOne,Tick,191,146,45,-45,147400,147900,4571,13529,4529,OK
27.248613,TraderOne,Tick,201,146,55,-55,147400,147900,4423,17677,6677,OK
27.550133,TraderOne,Tick,201,146,55,-55,147400,147900,4423,17677,6677,OK
27.745671,TraderOne,Tick,201,146,55,-55,147400,147800,4423,17677,6677,OK
27.993949,TraderOne,Tick,211,156,55,-55,147200,147800,4128,17972,6972,OK
28.220042,TraderOne,Tick,211,156,55,-55,147200,147800,4128,17972,6972,OK
28.532334,TraderOne,Tick,211,166,45,-45,147700,147800,3981,13119,8619,OK
28.773299,TraderOne,Tick,211,166,45,-45,147700,147600,3981,13119,17619,OK
29.009242,TraderOne,Tick,211,166,45,-45,147700,147600,3981,13119,17619,OK
29.218132,TraderOne,Tick,211,166,45,-45,147700,147600,3981,13119,17619,OK
29.544139,TraderOne,Tick,211,166,45,-45,147700,147600,3981,13119,17619,OK
29.731777,TraderOne,Tick,211,176,35,-35,147100,147600,4275,9825,2825,OK
29.993305,TraderOne,Tick,211,186,25,-25,147700,147600,4128,6972,9472,OK
30.202524,TraderOne,Tick,221,186,35,-35,147000,147600,3981,9119,2119,OK
30.457114,TraderOne,Tick,221,186,35,-35,147000,147600,3981,9119,2119,OK
30.746047,TraderOne,Tick,221,186,35,-35,147000,147400,3981,9119,2119,OK
31.015228,TraderOne,Tick,231,186,45,-45,147000,147400,4275,11825,2825,OK
31.213077,TraderOne,Tick,241,186,55,-55,147000,147400,4569,15531,4531,OK
31.546803,TraderOne,Tick,251,186,65,-65,147000,147400,4863,19237,6237,OK
31.729214,TraderOne,Tick,251,186,65,-65,147000,147400,4863,19237,6237,OK
31.955531,TraderOne,Tick,261,186,75,-75,147000,147400,4716,25384,10384,OK
32.236716,TraderOne,Tick,261,196,65,-65,147100,147400,4569,18531,5531,OK
32.499681,TraderOne,Tick,261,206,55,-55,147100,147400,4863,12237,1237,OK
32.750964,TraderOne,Tick,261,206,55,-55,147100,147600,4863,12237,1237,OK
33.001874,TraderOne,Tick,261,216,45,-45,147000,147600,5157,6943,-2057,OK
33.222667,TraderOne,Tick,261,216,45,-45,147000,147600,5157,6943,-2057,OK
33.51199,TraderOne,Tick,261,216,45,-45,147000,147600,5157,6943,-2057,OK
33.756557,TraderOne,Tick,261,226,35,-35,146900,147600,5451,2649,-4351,OK
34.036493,TraderOne,Tick,261,226,35,-35,146900,147600,5451,2649,-4351,OK
34.218035,TraderOne,Tick,261,226,35,-35,146900,147200,5451,2649,-4351,OK
34.517564,TraderOne,Tick,261,226,35,-35,146900,147200,5451,2649,-4351,OK
34.795096,TraderOne,Tick,261,226,35,-35,146900,147200,5451,2649,-4351,OK
35.023759,TraderOne,Tick,261,226,35,-35,146900,147200,5451,2649,-4351,OK
35.223715,TraderOne,Tick,261,226,35,-35,146900,147300,5451,2649,-4351,OK
35.534301,TraderOne,Tick,261,236,25,-25,147100,147000,5304,-2204,296,OK
35.715832,TraderOne,Tick,261,246,15,-15,147200,147000,5598,-3498,-498,OK
35.985457,TraderOne,Tick,261,246,15,-15,147200,147000,5598,-3498,-498,OK
36.29943,TraderOne,Tick,261,246,15,-15,147200,147000,5598,-3498,-498,OK
36.537483,TraderOne,Tick,261,253,8,-8,147200,147000,5804,-4404,-2804,OK
36.758623,TraderOne,Tick,261,253,8,-8,147200,147000,5804,-4404,-2804,OK
36.962586,TraderOne,Tick,261,253,8,-8,147200,147000,5804,-4404,-2804,OK
37.28486,TraderOne,Tick,261,253,8,-8,147200,147000,5804,-4404,-2804,OK
37.506314,TraderOne,Tick,261,253,8,-8,147200,147300,5804,-4404,-5204,OK
37.76068,TraderOne,Tick,261,253,8,-8,147200,147300,5804,-4404,-5204,OK
37.99899,TraderOne,Tick,261,253,8,-8,147200,147300,5804,-4404,-5204,OK
38.231906,TraderOne,Tick,261,253,8,-8,147200,147300,5804,-4404,-5204,OK
38.520839,TraderOne,Tick,261,253,8,-8,147200,147300,5804,-4404,-5204,OK
38.730599,TraderOne,Tick,261,253,8,-8,147200,147300,5804,-4404,-5204,OK
38.959714,TraderOne,Tick,271,253,18,-18,147500,147300,6099,-4699,-1099,OK
39.203046,TraderOne,Tick,281,253,28,-28,147000,147300,5952,-3552,-9152,OK
39.529541,TraderOne,Tick,281,263,18,-18,147700,147300,5804,-4404,-804,OK
39.799205,TraderOne,Tick,281,263,18,-18,147700,147300,5804,-4404,-804,OK
40.007013,TraderOne,Tick,281,263,18,-18,147700,147300,5804,-4404,-804,OK
40.296427,TraderOne,Tick,281,263,18,-18,147700,147300,5804,-4404,-804,OK
40.492273,TraderOne,Tick,281,273,8,-8,147700,147300,5657,-4257,-2657,OK
40.731923,TraderOne,Tick,281,273,8,-8,147700,147300,5657,-4257,-2657,OK
41.01663,TraderOne,Tick,281,273,8,-8,147700,147300,5657,-4257,-2657,OK
41.25816,TraderOne,Tick,281,273,8,-8,147700,147300,5657,-4257,-2657,OK
41.525093,TraderOne,Tick,281,273,8,-8,147700,147300,5657,-4257,-2657,OK
41.7396,TraderOne,Tick,281,273,8,-8,147700,147300,5657,-4257,-2657,OK
42.025733,TraderOne,Tick,281,273,8,-8,147700,147200,5657,-4257,-2657,OK
42.278057,TraderOne,Tick,281,281,0,0,147400,147200,5539,-4139,-4139,OK
42.510933,TraderOne,Tick,281,281,0,0,147400,147200,5539,-4139,-4139,OK
42.701195,TraderOne,Tick,281,281,0,0,147400,147200,5539,-4139,-4139,OK
43.040455,TraderOne,Tick,281,281,0,0,147400,147200,5539,-4139,-4139,OK
43.22995,TraderOne,Tick,281,281,0,0,147400,147200,5539,-4139,-4139,OK
43.531277,TraderOne,Tick,281,281,0,0,147400,147200,5539,-4139,-4139,OK
43.713212,TraderOne,Tick,281,281,0,0,147400,147400,5539,-4139,-4139,OK
43.950887,TraderOne,Tick,281,281,0,0,147400,147400,5539,-4139,-4139,OK
44.236488,TraderOne,Tick,281,281,0,0,147400,147400,5539,-4139,-4139,OK
44.486373,TraderOne,Tick,281,281,0,0,147400,147400,5539,-4139,-4139,OK
44.767866,TraderOne,Tick,281,281,0,0,147400,147400,5539,-4139,-4139,OK
45.023613,TraderOne,Tick,281,291,-10,10,147700,147400,5391,-2991,-4991,OK
45.242887,TraderOne,Tick,281,291,-10,10,147700,147400,5391,-2991,-4991,OK
45.499798,TraderOne,Tick,281,291,-10,10,147700,147500,5391,-2991,-4991,OK
45.768694,TraderOne,Tick,281,301,-20,20,147400,147500,5686,-3286,-1286,OK
46.030629,TraderOne,Tick,281,301,-20,20,147400,147500,5686,-3286,-1286,OK
46.21452,TraderOne,Tick,281,301,-20,20,147400,147500,5686,-3286,-1286,OK
46.514324,TraderOne,Tick,281,301,-20,20,147400,147500,5686,-3286,-1286,OK
46.770064,TraderOne,Tick,281,301,-20,20,147400,147500,5686,-3286,-1286,OK
47.007607,TraderOne,Tick,281,309,-28,28,147400,147500,5922,-1922,878,OK
47.276669,TraderOne,Tick,281,309,-28,28,147400,147500,5922,-1922,878,OK
47.463839,TraderOne,Tick,281,309,-28,28,147400,147500,5922,-1922,878,OK
47.727143,TraderOne,Tick,281,319,-38,38,147700,147500,5774,226,-7374,OK
48.004685,TraderOne,Tick,281,319,-38,38,147700,147500,5774,226,-7374,OK
48.267897,TraderOne,Tick,291,319,-28,28,147100,147500,5627,-3627,1973,OK
48.493654,TraderOne,Tick,291,319,-28,28,147100,147500,5627,-3627,1973,OK
48.74497,TraderOne,Tick,291,319,-28,28,147100,147500,5627,-3627,1973,OK
49.012827,TraderOne,Tick,291,319,-28,28,147100,147500,5627,-3627,1973,OK
49.266209,TraderOne,Tick,291,319,-28,28,147100,147500,5627,-3627,1973,OK
49.496106,TraderOne,Tick,291,319,-28,28,147100,147500,5627,-3627,1973,OK
49.799736,TraderOne,Tick,291,319,-28,28,147100,147500,5627,-3627,1973,OK
50.044364,TraderOne,Tick,291,319,-28,28,147100,147500,5627,-3627,1973,OK
50.227183,TraderOne,Tick,291,319,-28,28,147100,147500,5627,-3627,1973,OK
50.541448,TraderOne,Tick,291,319,-28,28,147700,147500,5627,-3627,-9227,OK
50.76735,TraderOne,Tick,291,319,-28,28,147700,147500,5627,-3627,-9227,OK
51.037034,TraderOne,Tick,291,319,-28,28,147700,147500,5627,-3627,-9227,OK
51.292667,TraderOne,Tick,291,319,-28,28,147700,147500,5627,-3627,-9227,OK
51.492672,TraderOne,Tick,291,319,-28,28,147700,147500,5627,-3627,-9227,OK
51.763195,TraderOne,Tick,291,319,-28,28,147700,147500,5627,-3627,-9227,OK
52.046573,TraderOne,Tick,291,319,-28,28,147700,147300,5627,-3627,-9227,OK
52.229508,TraderOne,Tick,291,319,-28,28,147700,147300,5627,-3627,-9227,OK
52.503909,TraderOne,Tick,291,319,-28,28,147700,147300,5627,-3627,-9227,OK
52.727346,TraderOne,Tick,291,319,-28,28,147700,147300,5627,-3627,-9227,OK
53.014156,TraderOne,Tick,291,319,-28,28,147700,147300,5627,-3627,-9227,OK
53.212214,TraderOne,Tick,291,319,-28,28,147700,147300,5627,-3627,-9227,OK
53.459403,TraderOne,Tick,291,319,-28,28,147700,147300,5627,-3627,-9227,OK
53.76719,TraderOne,Tick,291,319,-28,28,147700,147300,5627,-3627,-9227,OK
54.030867,TraderOne,Tick,291,319,-28,28,147700,147300,5627,-3627,-9227,OK
54.304457,TraderOne,Tick,291,319,-28,28,147800,147200,5627,-3627,-9227,OK
54.485074,TraderOne,Tick,291,319,-28,28,147800,147200,5627,-3627,-9227,OK
54.709718,TraderOne,Tick,291,319,-28,28,147800,147200,5627,-3627,-9227,OK
55.017454,TraderOne,Tick,291,319,-28,28,147800,147200,5627,-3627,-9227,OK
55.223516,TraderOne,Tick,291,319,-28,28,147300,147300,5627,-3627,-3627,OK
55.536115,TraderOne,Tick,291,319,-28,28,147300,146900,5627,-3627,-9227,OK
55.718281,TraderOne,Tick,302,329,-27,27,147200,146900,5760,-6960,-12360,OK
56.022696,TraderOne,Tick,302,329,-27,27,147200,147100,5760,-6960,-9660,OK
56.287137,TraderOne,Tick,302,329,-27,27,147200,147100,5760,-6960,-9660,OK
56.512469,TraderOne,Tick,302,329,-27,27,147200,147100,5760,-6960,-9660,OK
56.709965,TraderOne,Tick,302,329,-27,27,147200,147100,5760,-6960,-9660,OK
56.979061,TraderOne,Tick,302,339,-37,37,147100,147100,6054,-5254,-5254,OK
57.290699,TraderOne,Tick,302,339,-37,37,147100,147100,6054,-5254,-5254,OK
57.484483,TraderOne,Tick,302,339,-37,37,147100,146800,6054,-5254,-12654,OK
57.787215,TraderOne,Tick,302,349,-47,47,147000,146600,6348,-1848,-11248,OK
57.97043,TraderOne,Tick,302,349,-47,47,147000,146600,6348,-1848,-11248,OK
58.274654,TraderOne,Tick,302,349,-47,47,147000,146700,6348,-1848,-11248,OK
58.541365,TraderOne,Tick,302,349,-47,47,147000,146700,6348,-1848,-11248,OK
58.745778,TraderOne,Tick,302,349,-47,47,147000,146700,6348,-1848,-11248,OK
59.023932,TraderOne,Tick,302,349,-47,47,147000,146700,6348,-1848,-11248,OK
59.213583,TraderOne,Tick,302,359,-57,57,147000,146700,6642,1858,-9542,OK
59.480092,TraderOne,Tick,302,359,-57,57,147000,146500,6642,1858,-9542,OK
59.735671,TraderOne,Tick,302,359,-57,57,147000,146500,6642,1858,-9542,OK
59.951894,TraderOne,Tick,302,359,-57,57,147000,146500,6642,1858,-9542,OK
60.228715,TraderOne,Tick,302,359,-57,57,147000,146700,6642,1858,-9542,OK
60.499965,TraderOne,Tick,302,359,-57,57,147000,146700,6642,1858,-9542,OK
60.788564,TraderOne,Tick,302,359,-57,57,147000,146500,6642,1858,-9542,OK
61.048032,TraderOne,Tick,302,359,-57,57,147000,146500,6642,1858,-9542,OK
61.25922,TraderOne,Tick,302,359,-57,57,147000,146500,6642,1858,-9542,OK
61.492525,TraderOne,Tick,302,359,-57,57,147000,146500,6642,1858,-9542,OK
61.729005,TraderOne,Tick,302,359,-57,57,147000,146500,6642,1858,-9542,OK
61.980893,TraderOne,Tick,302,359,-57,57,147000,146500,6642,1858,-9542,OK
62.22992,TraderOne,Tick,302,359,-57,57,147000,146500,6642,1858,-9542,OK
62.490027,TraderOne,Tick,302,369,-67,67,146800,146300,6936,7564,-5836,OK
62.764081,TraderOne,Tick,312,369,-57,57,146800,146300,7230,1270,-10130,OK
63.042746,TraderOne,Tick,322,369,-47,47,146800,146300,7083,-4583,-13983,OK
63.244775,TraderOne,Tick,322,369,-47,47,146800,146300,7083,-4583,-13983,OK
63.54689,TraderOne,Tick,322,369,-47,47,146800,146300,7083,-4583,-13983,OK
63.800002,TraderOne,Tick,322,369,-47,47,146800,146300,7083,-4583,-13983,OK
64.045657,TraderOne,Tick,322,369,-47,47,146800,146300,7083,-4583,-13983,OK
64.281026,TraderOne,Tick,332,369,-37,37,146700,146300,7377,-7877,-15277,OK
64.477786,TraderOne,Tick,332,369,-37,37,146700,146300,7377,-7877,-15277,OK
64.742724,TraderOne,Tick,332,369,-37,37,146700,146300,7377,-7877,-15277,OK
65.036387,TraderOne,Tick,332,369,-37,37,146700,146300,7377,-7877,-15277,OK
65.255952,TraderOne,Tick,332,369,-37,37,146700,146900,7377,-7877,-477,OK
65.525645,TraderOne,Tick,332,369,-37,37,146700,146900,7377,-7877,-477,OK
65.797427,TraderOne,Tick,332,369,-37,37,146700,146900,7377,-7877,-477,OK
65.971135,TraderOne,Tick,342,369,-27,27,146600,146900,7230,-10730,-5330,OK
66.248424,TraderOne,Tick,342,369,-27,27,146600,146900,7230,-10730,-5330,OK
66.53356,TraderOne,Tick,342,379,-37,37,147300,146900,7083,-7583,-14983,OK
66.73237,TraderOne,Tick,342,379,-37,37,147300,146900,7083,-7583,-14983,OK
67.004258,TraderOne,Tick,352,379,-27,27,146500,146900,6936,-9436,-4036,OK
67.292758,TraderOne,Tick,352,379,-27,27,146500,146900,6936,-9436,-4036,OK
67.460498,TraderOne,Tick,362,379,-17,17,146900,146900,6789,-11289,-11289,OK
67.745941,TraderOne,Tick,362,379,-17,17,146900,146900,6789,-11289,-11289,OK
68.028979,TraderOne,Tick,362,379,-17,17,146900,146900,6789,-11289,-11289,OK
68.268638,TraderOne,Tick,362,389,-27,27,146900,146900,6642,-11142,-11142,OK
68.484559,TraderOne,Tick,372,399,-27,27,146500,146900,6789,-10289,-4889,OK
68.720326,TraderOne,Tick,372,399,-27,27,146500,147200,6789,-10289,-4889,OK
68.999721,TraderOne,Tick,372,399,-27,27,146500,147200,6789,-10289,-4889,OK
69.233382,TraderOne,Tick,372,409,-37,37,147500,147200,6642,-8142,-15542,OK
69.488745,TraderOne,Tick,372,409,-37,37,147500,147200,6642,-8142,-15542,OK
69.788186,TraderOne,Tick,372,409,-37,37,147500,147300,6642,-8142,-15542,OK
69.956381,TraderOne,Tick,372,409,-37,37,147500,147300,6642,-8142,-15542,OK
70.205157,TraderOne,Tick,372,409,-37,37,147500,147300,6642,-8142,-15542,OK
70.534279,TraderOne,Tick,372,409,-37,37,147500,147300,6642,-8142,-15542,OK
70.73877,TraderOne,Tick,382,409,-27,27,146500,147300,6495,-10995,-5595,OK
70.974778,TraderOne,Tick,382,409,-27,27,146500,147300,6495,-10995,-5595,OK
71.200438,TraderOne,Tick,382,409,-27,27,146500,147300,6495,-10995,-5595,OK
71.480369,TraderOne,Tick,382,409,-27,27,146500,147300,6495,-10995,-5595,OK
71.736832,TraderOne,Tick,382,409,-27,27,146500,147300,6495,-10995,-5595,OK
72.039304,TraderOne,Tick,382,409,-27,27,146500,147300,6495,-10995,-5595,OK
72.284827,TraderOne,Tick,383,409,-26,26,147500,147300,6525,-11325,-16525,OK
72.507479,TraderOne,Tick,383,409,-26,26,147500,147300,6525,-11325,-16525,OK
72.775347,TraderOne,Tick,383,409,-26,26,147500,147300,6525,-11325,-16525,OK
73.028152,TraderOne,Tick,383,409,-26,26,147600,147300,6525,-11325,-16525,OK
73.256217,TraderOne,Tick,383,409,-26,26,147600,147300,6525,-11325,-16525,OK
73.463907,TraderOne,Tick,383,409,-26,26,147600,147200,6525,-11325,-16525,OK
73.769179,TraderOne,Tick,383,409,-26,26,147600,147200,6525,-11325,-16525,OK
74.020983,TraderOne,Tick,383,409,-26,26,147600,147200,6525,-11325,-16525,OK
74.226351,TraderOne,Tick,393,409,-16,16,147600,147200,6820,-13620,-16820,OK
74.471456,TraderOne,Tick,393,409,-16,16,147600,147200,6820,-13620,-16820,OK
74.756503,TraderOne,Tick,393,419,-26,26,147500,147200,7115,-12915,-18115,OK
75.032182,TraderOne,Tick,393,419,-26,26,147500,147200,7115,-12915,-18115,OK
75.269225,TraderOne,Tick,393,419,-26,26,147500,147400,7115,-12915,-15515,OK
75.533591,TraderOne,Tick,393,419,-26,26,147500,147400,7115,-12915,-15515,OK
75.701664,TraderOne,Tick,393,419,-26,26,147500,147400,7115,-12915,-15515,OK
76.021685,TraderOne,Tick,393,419,-26,26,147500,147400,7115,-12915,-15515,OK
76.22159,TraderOne,Tick,393,419,-26,26,147500,147400,7115,-12915,-15515,OK
76.507079,TraderOne,Tick,393,419,-26,26,147500,147500,7115,-12915,-12915,OK
76.71332,TraderOne,Tick,403,419,-16,16,147600,147600,7410,-14210,-14210,OK
76.964275,TraderOne,Tick,403,419,-16,16,147600,147600,7410,-14210,-14210,OK
77.302071,TraderOne,Tick,403,429,-26,26,147500,147600,7705,-13505,-10905,OK
77.533133,TraderOne,Tick,403,429,-26,26,147500,147600,7705,-13505,-10905,OK
77.720423,TraderOne,Tick,413,429,-16,16,147400,147600,7558,-15358,-12158,OK
78.048289,TraderOne,Tick,413,429,-16,16,147400,147600,7558,-15358,-12158,OK
78.297277,TraderOne,Tick,413,429,-16,16,147400,147600,7558,-15358,-12158,OK
78.525392,TraderOne,Tick,423,429,-6,6,147400,147600,7853,-16653,-15453,OK
78.788324,TraderOne,Tick,423,429,-6,6,147400,147600,7853,-16653,-15453,OK
78.997265,TraderOne,Tick,423,429,-6,6,147400,147600,7853,-16653,-15453,OK
79.245479,TraderOne,Tick,433,429,4,-4,147600,147600,8148,-16748,-16748,OK
79.518765,TraderOne,Tick,443,429,14,-14,147600,147600,8443,-17043,-17043,OK
79.792348,TraderOne,Tick,453,429,24,-24,147600,148500,8738,-15338,-20138,OK
79.959342,TraderOne,Tick,463,429,34,-34,147900,148400,9034,-10234,-17034,OK
80.227353,TraderOne,Tick,473,429,44,-44,147900,148400,9330,-7530,-16330,OK
80.49889,TraderOne,Tick,473,429,44,-44,147900,148400,9330,-7530,-16330,OK
80.748485,TraderOne,Tick,473,429,44,-44,147900,148400,9330,-7530,-16330,OK
80.983468,TraderOne,Tick,483,429,54,-54,147900,148400,9626,-3826,-14626,OK
81.283621,TraderOne,Tick,483,429,54,-54,147900,148200,9626,-3826,-14626,OK
81.495533,TraderOne,Tick,483,429,54,-54,147900,148400,9626,-3826,-14626,OK
81.7872,TraderOne,Tick,483,439,44,-44,148100,148400,9478,-12678,-21478,OK
81.996809,TraderOne,Tick,493,439,54,-54,148000,148400,9774,-8974,-19774,OK
82.218026,TraderOne,Tick,493,439,54,-54,148000,148400,9774,-8974,-19774,OK
82.542056,TraderOne,Tick,503,449,54,-54,148200,148800,9922,-11122,-21922,OK
82.739365,TraderOne,Tick,503,449,54,-54,148200,148800,9922,-11122,-21922,OK
83.005756,TraderOne,Tick,503,449,54,-54,148200,148800,9922,-11122,-21922,OK
83.272529,TraderOne,Tick,503,449,54,-54,148300,148800,9922,-11122,-21922,OK
83.50819,TraderOne,Tick,503,449,54,-54,148300,148800,9922,-11122,-21922,OK
83.795629,TraderOne,Tick,503,449,54,-54,148300,148800,9922,-11122,-21922,OK
84.000076,TraderOne,Tick,503,449,54,-54,148400,149000,9922,-11122,-21922,OK
84.264564,TraderOne,Tick,503,449,54,-54,148400,149000,9922,-11122,-21922,OK
84.458003,TraderOne,Tick,503,449,54,-54,148400,149000,9922,-11122,-21922,OK
84.786652,TraderOne,Tick,503,449,54,-54,148400,149200,9922,-11122,-21922,OK
85.004286,TraderOne,Tick,503,449,54,-54,148600,149200,9922,-11122,-21922,OK
85.211028,TraderOne,Tick,503,449,54,-54,148600,149200,9922,-11122,-21922,OK
85.523034,TraderOne,Tick,513,459,54,-54,148800,149200,9624,-10824,-21624,OK
85.78842,TraderOne,Tick,513,469,44,-44,148700,149200,9475,-17675,-26475,OK
85.959158,TraderOne,Tick,523,469,54,-54,148800,149600,9773,-12973,-23773,OK
86.293937,TraderOne,Tick,533,479,54,-54,149000,149600,9922,-14122,-24922,OK
86.516553,TraderOne,Tick,533,479,54,-54,149000,149600,9922,-14122,-24922,OK
86.730218,TraderOne,Tick,533,489,44,-44,149600,149600,9773,-18973,-18973,OK
86.963429,TraderOne,Tick,533,489,44,-44,149600,149600,9773,-18973,-18973,OK
87.202689,TraderOne,Tick,533,489,44,-44,149600,149600,9773,-18973,-18973,OK
87.544346,TraderOne,Tick,533,489,44,-44,149600,149700,9773,-18973,-23373,OK
87.777437,TraderOne,Tick,533,489,44,-44,149600,149600,9773,-18973,-18973,OK
87.987125,TraderOne,Tick,533,489,44,-44,149600,149500,9773,-18973,-14573,OK
88.296194,TraderOne,Tick,533,489,44,-44,149600,149500,9773,-18973,-14573,OK
88.520097,TraderOne,Tick,533,489,44,-44,149600,149200,9773,-18973,-10173,OK
88.766571,TraderOne,Tick,533,489,44,-44,149600,149100,9773,-18973,-10173,OK
88.965152,TraderOne,Tick,533,489,44,-44,149600,149100,9773,-18973,-10173,OK
89.274381,TraderOne,Tick,533,489,44,-44,149600,149100,9773,-18973,-10173,OK
89.477668,TraderOne,Tick,533,489,44,-44,149600,148900,9773,-18973,-10173,OK
89.727391,TraderOne,Tick,533,489,44,-44,149600,148900,9773,-18973,-10173,OK
89.967911,TraderOne,Tick,533,489,44,-44,149600,148900,9773,-18973,-10173,OK
90.274944,TraderOne,Tick,533,489,44,-44,149600,149100,9773,-18973,-10173,OK
90.514058,TraderOne,Tick,533,489,44,-44,149600,149100,9773,-18973,-10173,OK
90.727367,TraderOne,Tick,533,489,44,-44,149600,149100,9773,-18973,-10173,OK
91.024481,TraderOne,Tick,533,499,34,-34,148700,149100,9624,-22824,-29624,OK
91.234646,TraderOne,Tick,533,509,24,-24,149400,149100,9923,-20123,-15323,OK
91.48905,TraderOne,Tick,533,514,19,-19,149400,148900,10072,-18272,-14472,OK
91.749086,TraderOne,Tick,533,524,9,-9,149600,148900,9923,-20123,-18323,OK
91.997905,TraderOne,Tick,533,524,9,-9,149600,148900,9923,-20123,-18323,OK
92.270004,TraderOne,Tick,543,524,19,-19,148500,148900,9774,-19974,-23774,OK
92.51786,TraderOne,Tick,543,524,19,-19,148500,148900,9774,-19974,-23774,OK
92.74092,TraderOne,Tick,543,524,19,-19,148500,148900,9774,-19974,-23774,OK
93.01516,TraderOne,Tick,543,524,19,-19,148500,149200,9774,-19974,-23774,OK
93.277205,TraderOne,Tick,543,524,19,-19,148500,149200,9774,-19974,-23774,OK
93.462157,TraderOne,Tick,543,524,19,-19,148500,149200,9774,-19974,-23774,OK
93.749458,TraderOne,Tick,543,524,19,-19,148500,149200,9774,-19974,-23774,OK
93.958597,TraderOne,Tick,543,524,19,-19,148500,149200,9774,-19974,-23774,OK
94.222891,TraderOne,Tick,543,524,19,-19,148500,149200,9774,-19974,-23774,OK
94.452211,TraderOne,Tick,543,524,19,-19,148500,149200,9774,-19974,-23774,OK
94.749998,TraderOne,Tick,543,524,19,-19,148500,149200,9774,-19974,-23774,OK
95.041246,TraderOne,Tick,543,524,19,-19,148500,149200,9774,-19974,-23774,OK
95.270635,TraderOne,Tick,543,524,19,-19,148500,149200,9774,-19974,-23774,OK
95.470833,TraderOne,Tick,543,524,19,-19,148500,149200,9774,-19974,-23774,OK
95.785007,TraderOne,Tick,543,524,19,-19,148500,149200,9774,-19974,-23774,OK
95.959451,TraderOne,Tick,543,524,19,-19,148500,149200,9774,-19974,-23774,OK
96.302809,TraderOne,Tick,543,524,19,-19,148500,149200,9774,-19974,-23774,OK
96.505305,TraderOne,Tick,543,524,19,-19,148500,149200,9774,-19974,-23774,OK
96.719416,TraderOne,Tick,550,524,26,-26,149600,149200,9983,-19483,-14283,OK
97.036296,TraderOne,Tick,550,524,26,-26,149600,149200,9983,-19483,-14283,OK
97.211594,TraderOne,Tick,550,524,26,-26,149600,149200,9983,-19483,-14283,OK
97.506316,TraderOne,Tick,560,534,26,-26,149800,149600,9684,-19184,-13984,OK
97.772403,TraderOne,Tick,560,534,26,-26,149800,149800,9684,-19184,-19184,OK
98.039499,TraderOne,Tick,560,534,26,-26,149800,149800,9684,-19184,-19184,OK
98.264308,TraderOne,Tick,560,534,26,-26,149800,149800,9684,-19184,-19184,OK
98.514533,TraderOne,Tick,570,544,26,-26,149800,149800,9384,-18884,-18884,OK
98.712599,TraderOne,Tick,570,544,26,-26,149800,149800,9384,-18884,-18884,OK
98.973499,TraderOne,Tick,570,544,26,-26,149800,149800,9384,-18884,-18884,OK
99.282358,TraderOne,Tick,570,544,26,-26,149800,150100,9384,-18884,-26684,OK
99.507611,TraderOne,Tick,580,544,36,-36,149800,150000,9684,-17184,-24384,OK
99.803519,TraderOne,Tick,580,544,36,-36,149800,150000,9684,-17184,-24384,OK
100.039952,TraderOne,Tick,580,554,26,-26,149900,150000,9534,-20034,-22634,OK
100.221231,TraderOne,Tick,580,554,26,-26,149900,149900,9534,-20034,-20034,OK
100.468539,TraderOne,Tick,580,554,26,-26,149900,149900,9534,-20034,-20034,OK
100.792478,TraderOne,Tick,580,554,26,-26,149900,149900,9534,-20034,-20034,OK
101.013337,TraderOne,Tick,580,554,26,-26,149900,149900,9534,-20034,-20034,OK
101.294472,TraderOne,Tick,590,554,36,-36,149400,149900,9384,-17884,-28684,OK
101.481521,TraderOne,Tick,590,554,36,-36,149400,150100,9384,-17884,-28684,OK
101.726228,TraderOne,Tick,590,554,36,-36,149400,150100,9384,-17884,-28684,OK
101.991683,TraderOne,Tick,590,554,36,-36,149400,150100,9384,-17884,-28684,OK
102.277554,TraderOne,Tick,590,554,36,-36,149400,150100,9384,-17884,-28684,OK
102.515486,TraderOne,Tick,590,554,36,-36,149400,150100,9384,-17884,-28684,OK
102.728904,TraderOne,Tick,600,554,46,-46,149900,150300,9684,-15184,-28984,OK
102.992979,TraderOne,Tick,600,554,46,-46,149900,150300,9684,-15184,-28984,OK
103.20234,TraderOne,Tick,600,554,46,-46,149900,150300,9684,-15184,-28984,OK
103.454984,TraderOne,Tick,604,556,48,-48,149900,150300,9594,-14094,-28494,OK
103.73859,TraderOne,Tick,604,556,48,-48,149900,150300,9594,-14094,-28494,OK
104.004326,TraderOne,Tick,604,556,48,-48,149900,150400,9594,-14094,-28494,OK
104.211333,TraderOne,Tick,604,556,48,-48,149900,150400,9594,-14094,-28494,OK
104.547443,TraderOne,Tick,604,556,48,-48,149900,150200,9594,-14094,-28494,OK
104.790266,TraderOne,Tick,604,556,48,-48,149900,150200,9594,-14094,-28494,OK
104.976736,TraderOne,Tick,604,556,48,-48,149900,150200,9594,-14094,-28494,OK
105.265084,TraderOne,Tick,604,556,48,-48,149900,150200,9594,-14094,-28494,OK
105.486541,TraderOne,Tick,604,556,48,-48,149900,150200,9594,-14094,-28494,OK
105.758807,TraderOne,Tick,604,556,48,-48,149900,150200,9594,-14094,-28494,OK
105.996326,TraderOne,Tick,604,556,48,-48,149900,150300,9594,-14094,-28494,OK
106.253925,TraderOne,Tick,604,566,38,-38,150000,150500,9444,-19944,-31344,OK
106.546168,TraderOne,Tick,614,566,48,-48,150200,150500,9294,-16794,-31194,OK
106.744586,TraderOne,Tick,614,566,48,-48,150200,150400,9294,-16794,-26394,OK
106.974315,TraderOne,Tick,614,566,48,-48,150200,150300,9294,-16794,-21594,OK
107.234016,TraderOne,Tick,614,566,48,-48,150200,150300,9294,-16794,-21594,OK
107.451541,TraderOne,Tick,614,566,48,-48,150200,150400,9294,-16794,-26394,OK
107.756792,TraderOne,Tick,614,566,48,-48,150200,150400,9294,-16794,-26394,OK
107.989994,TraderOne,Tick,614,566,48,-48,150200,150400,9294,-16794,-26394,OK
108.272953,TraderOne,Tick,614,566,48,-48,150200,150300,9294,-16794,-21594,OK
108.493049,TraderOne,Tick,614,566,48,-48,150200,150100,9294,-16794,-11994,OK
108.775145,TraderOne,Tick,614,576,38,-38,149600,150100,9594,-22094,-33494,OK
109.035467,TraderOne,Tick,614,576,38,-38,149600,150100,9594,-22094,-33494,OK
109.254228,TraderOne,Tick,614,576,38,-38,149600,150100,9594,-22094,-33494,OK
109.454885,TraderOne,Tick,614,576,38,-38,149600,150100,9594,-22094,-33494,OK
109.741891,TraderOne,Tick,614,586,28,-28,149900,150100,9444,-24944,-30544,OK
110.020175,TraderOne,Tick,614,596,18,-18,150100,150100,9744,-25244,-25244,OK
110.217487,TraderOne,Tick,624,596,28,-28,150200,150500,10044,-23544,-31944,OK
110.501297,TraderOne,Tick,634,596,38,-38,150200,150500,10344,-21844,-33244,OK
110.73456,TraderOne,Tick,644,596,48,-48,150200,150700,10644,-19144,-33544,OK
111.034335,TraderOne,Tick,654,596,58,-58,150200,150600,10944,-15444,-32844,OK
111.269037,TraderOne,Tick,654,596,58,-58,150200,150600,10944,-15444,-32844,OK
111.503987,TraderOne,Tick,654,606,48,-48,150600,150600,11244,-20744,-20744,OK
111.741402,TraderOne,Tick,654,606,48,-48,150100,150600,11244,-20744,-35144,OK
111.963473,TraderOne,Tick,654,606,48,-48,150100,150600,11244,-20744,-35144,OK
112.204668,TraderOne,Tick,654,606,48,-48,150100,150500,11244,-20744,-35144,OK
112.452924,TraderOne,Tick,654,616,38,-38,150100,150400,11544,-25044,-36444,OK
112.763149,TraderOne,Tick,654,616,38,-38,150100,150500,11544,-25044,-36444,OK
113.017105,TraderOne,Tick,654,616,38,-38,150100,150700,11544,-25044,-36444,OK
113.290975,TraderOne,Tick,654,616,38,-38,150100,150600,11544,-25044,-36444,OK
113.525337,TraderOne,Tick,654,616,38,-38,150100,150500,11544,-25044,-36444,OK
113.70767,TraderOne,Tick,654,616,38,-38,150100,150500,11544,-25044,-36444,OK
114.028228,TraderOne,Tick,654,616,38,-38,150100,150500,11544,-25044,-36444,OK
114.217115,TraderOne,Tick,654,616,38,-38,150100,150600,11544,-25044,-36444,OK
114.479905,TraderOne,Tick,654,616,38,-38,150500,150500,11544,-25044,-25044,OK
114.768152,TraderOne,Tick,654,616,38,-38,150500,150500,11544,-25044,-25044,OK
115.036086,TraderOne,Tick,654,616,38,-38,150500,150900,11544,-25044,-36444,OK
115.2899,TraderOne,Tick,664,616,48,-48,150200,150500,11394,-25894,-40294,OK
115.46936,TraderOne,Tick,664,626,38,-38,150100,150500,11694,-29794,-41194,OK
115.743838,TraderOne,Tick,664,626,38,-38,150100,150500,11694,-29794,-41194,OK
116.032107,TraderOne,Tick,664,635,29,-29,150100,150400,11964,-32764,-41464,OK
116.275712,TraderOne,Tick,664,636,28,-28,150600,150500,11949,-33149,-30349,OK
116.48645,TraderOne,Tick,664,636,28,-28,150600,150800,11949,-33149,-38749,OK
116.777806,TraderOne,Tick,664,636,28,-28,150600,150500,11949,-33149,-30349,OK
116.994351,TraderOne,Tick,674,636,38,-38,150000,150500,11799,-30999,-42399,OK
117.282127,TraderOne,Tick,674,636,38,-38,150000,150300,11799,-30999,-42399,OK
117.465678,TraderOne,Tick,674,636,38,-38,150000,150300,11799,-30999,-42399,OK
117.798971,TraderOne,Tick,674,636,38,-38,150000,150300,11799,-30999,-42399,OK
118.013556,TraderOne,Tick,674,636,38,-38,150000,150300,11799,-30999,-42399,OK
118.284032,TraderOne,Tick,674,646,28,-28,150200,150500,11649,-33849,-42249,OK
118.539778,TraderOne,Tick,674,653,21,-21,150500,150500,11860,-34060,-34060,OK
118.772124,TraderOne,Tick,674,653,21,-21,150500,150300,11860,-34060,-29860,OK
118.952193,TraderOne,Tick,674,653,21,-21,150500,150300,11860,-34060,-29860,OK
119.295011,TraderOne,Tick,674,653,21,-21,150500,150300,11860,-34060,-29860,OK
119.531036,TraderOne,Tick,674,653,21,-21,150500,150300,11860,-34060,-29860,OK
119.743211,TraderOne,Tick,674,653,21,-21,150200,150100,11860,-34060,-31960,OK
119.983506,TraderOne,Tick,674,653,21,-21,150200,150100,11860,-34060,-31960,OK
120.290985,TraderOne,Tick,674,663,11,-11,150200,150600,11710,-41910,-45210,OK
120.547652,TraderOne,Tick,684,663,21,-21,150200,150600,12010,-39210,-45510,OK
120.755325,TraderOne,Tick,690,663,27,-27,150200,150600,12190,-37590,-45690,OK
120.993111,TraderOne,Tick,690,663,27,-27,150200,150600,12190,-37590,-45690,OK
121.27148,TraderOne,Tick,700,663,37,-37,150000,150600,12040,-35440,-46540,OK
121.530035,TraderOne,Tick,700,663,37,-37,150000,150600,12040,-35440,-46540,OK
121.767089,TraderOne,Tick,700,663,37,-37,150000,150600,12040,-35440,-46540,OK
121.977524,TraderOne,Tick,700,663,37,-37,150000,150600,12040,-35440,-46540,OK
122.211239,TraderOne,Tick,710,663,47,-47,150100,150600,11890,-33290,-47390,OK
122.544594,TraderOne,Tick,710,663,47,-47,150100,150500,11890,-33290,-47390,OK
122.753515,TraderOne,Tick,710,663,47,-47,150100,150500,11890,-33290,-47390,OK
123.041097,TraderOne,Tick,710,663,47,-47,150100,150500,11890,-33290,-47390,OK
123.28998,TraderOne,Tick,710,663,47,-47,150100,150400,11890,-33290,-47390,OK
123.451282,TraderOne,Tick,710,663,47,-47,150100,150400,11890,-33290,-47390,OK
123.763063,TraderOne,Tick,710,673,37,-37,150400,150400,11740,-37140,-37140,OK
123.993679,TraderOne,Tick,710,683,27,-27,150400,150400,11590,-39990,-39990,OK
124.291481,TraderOne,Tick,710,693,17,-17,150600,150400,11891,-41291,-37891,OK
124.457074,TraderOne,Tick,710,703,7,-7,150400,150400,12192,-42592,-42592,OK
124.704801,TraderOne,Tick,710,703,7,-7,150400,150400,12192,-42592,-42592,OK
124.98177,TraderOne,Tick,710,703,7,-7,150400,150400,12192,-42592,-42592,OK
125.220012,TraderOne,Tick,710,703,7,-7,150400,150400,12192,-42592,-42592,OK
125.47432,TraderOne,Tick,710,703,7,-7,150400,150400,12192,-42592,-42592,OK
125.79518,TraderOne,Tick,710,703,7,-7,150400,150400,12192,-42592,-42592,OK
126.048396,TraderOne,Tick,720,703,17,-17,150500,150700,12493,-41893,-45293,OK
126.282125,TraderOne,Tick,730,703,27,-27,150500,151100,12794,-41194,-49294,OK
126.502905,TraderOne,Tick,740,703,37,-37,150500,151200,13095,-36495,-47595,OK
126.752327,TraderOne,Tick,750,703,47,-47,150600,151000,13396,-32796,-46896,OK
126.973349,TraderOne,Tick,750,713,37,-37,150500,151000,13697,-37097,-48197,OK
127.277539,TraderOne,Tick,750,713,37,-37,150500,151000,13697,-37097,-48197,OK
127.489469,TraderOne,Tick,750,713,37,-37,150500,150700,13697,-37097,-44497,OK
127.726039,TraderOne,Tick,750,723,27,-27,150400,150500,13998,-39398,-42098,OK
127.950889,TraderOne,Tick,750,733,17,-17,150700,150300,13848,-40248,-35148,OK
128.285905,TraderOne,Tick,750,733,17,-17,150700,150300,13848,-40248,-35148,OK
128.525325,TraderOne,Tick,750,733,17,-17,150700,150200,13848,-40248,-35148,OK
128.746996,TraderOne,Tick,750,733,17,-17,150700,150200,13848,-40248,-35148,OK
128.963948,TraderOne,Tick,750,733,17,-17,150700,150200,13848,-40248,-35148,OK
129.201752,TraderOne,Tick,750,733,17,-17,150700,150200,13848,-40248,-35148,OK
129.477216,TraderOne,Tick,750,743,7,-7,151000,150400,13698,-42098,-39998,OK
129.71691,TraderOne,Tick,750,743,7,-7,151000,150400,13698,-42098,-39998,OK
130.026685,TraderOne,Tick,750,743,7,-7,151000,150400,13698,-42098,-39998,OK
130.263045,TraderOne,Tick,750,743,7,-7,151000,150400,13698,-42098,-39998,OK
130.503607,TraderOne,Tick,750,743,7,-7,151000,150400,13698,-42098,-39998,OK
130.799694,TraderOne,Tick,750,743,7,-7,151000,150400,13698,-42098,-39998,OK
131.033404,TraderOne,Tick,760,743,17,-17,149800,150400,13548,-41948,-47048,OK
131.230659,TraderOne,Tick,760,743,17,-17,149800,150100,13548,-41948,-47048,OK
131.454476,TraderOne,Tick,760,743,17,-17,149800,150100,13548,-41948,-47048,OK
131.733985,TraderOne,Tick,760,743,17,-17,149800,150100,13548,-41948,-47048,OK
131.961663,TraderOne,Tick,760,753,7,-7,150800,150100,13398,-41798,-39698,OK
132.227762,TraderOne,Tick,760,753,7,-7,150800,149800,13398,-41798,-39698,OK
132.545692,TraderOne,Tick,760,763,-3,3,149800,149800,13698,-43098,-43098,OK
132.764409,TraderOne,Tick,760,773,-13,13,149800,149600,13998,-41398,-43998,OK
133.0206,TraderOne,Tick,760,783,-23,23,149800,149600,14298,-39698,-44298,OK
133.240505,TraderOne,Tick,760,793,-33,33,150200,149600,14148,-37548,-44148,OK
133.502225,TraderOne,Tick,760,793,-33,33,150200,149600,14148,-37548,-44148,OK
133.774379,TraderOne,Tick,770,793,-23,23,149000,149500,13998,-40398,-35798,OK
133.964398,TraderOne,Tick,770,793,-23,23,149000,149600,13998,-40398,-35798,OK
134.211563,TraderOne,Tick,770,793,-23,23,149000,149600,13998,-40398,-35798,OK
134.49864,TraderOne,Tick,770,793,-23,23,149000,149700,13998,-40398,-35798,OK
134.720719,TraderOne,Tick,770,793,-23,23,149000,149700,13998,-40398,-35798,OK
135.040875,TraderOne,Tick,770,793,-23,23,149000,149800,13998,-40398,-33498,OK
135.234021,TraderOne,Tick,780,793,-13,13,149200,149800,13848,-42248,-38348,OK
135.4993,TraderOne,Tick,790,795,-5,5,149800,149900,13668,-41868,-41368,OK
135.792121,TraderOne,Tick,800,795,5,-5,149300,149900,13967,-37167,-38667,OK
135.997198,TraderOne,Tick,800,795,5,-5,149300,149900,13967,-37167,-38667,OK
136.282903,TraderOne,Tick,800,795,5,-5,149300,149900,13967,-37167,-38667,OK
136.452215,TraderOne,Tick,800,795,5,-5,149300,149900,13967,-37167,-38667,OK
136.780722,TraderOne,Tick,800,795,5,-5,149300,149800,13967,-37167,-38667,OK
136.974253,TraderOne,Tick,800,795,5,-5,149300,149600,13967,-37167,-38167,OK
137.267588,TraderOne,Tick,800,795,5,-5,149300,149600,13967,-37167,-38167,OK
137.464889,TraderOne,Tick,800,795,5,-5,149300,149600,13967,-37167,-38167,OK
137.720788,TraderOne,Tick,800,795,5,-5,149300,149300,13967,-37167,-37167,OK
137.977056,TraderOne,Tick,800,795,5,-5,149300,149300,13967,-37167,-37167,OK
138.283813,TraderOne,Tick,800,795,5,-5,149300,149300,13967,-37167,-37167,OK
138.531458,TraderOne,Tick,800,795,5,-5,149300,149300,13967,-37167,-37167,OK
138.707807,TraderOne,Tick,800,795,5,-5,149300,149100,13967,-37167,-36167,OK
138.966332,TraderOne,Tick,800,795,5,-5,149300,149100,13967,-37167,-36167,OK
139.2105,TraderOne,Tick,800,795,5,-5,149300,149100,13967,-37167,-36167,OK
139.459767,TraderOne,Tick,800,795,5,-5,149300,149300,13967,-37167,-37167,OK
139.778351,TraderOne,Tick,800,795,5,-5,149300,149300,13967,-37167,-37167,OK
139.976292,TraderOne,Tick,800,795,5,-5,149300,149300,13967,-37167,-37167,OK
140.206124,TraderOne,Tick,800,795,5,-5,149300,149300,13967,-37167,-37167,OK
140.467575,TraderOne,Tick,800,802,-2,2,149700,149300,13862,-37762,-38162,OK
140.748529,TraderOne,Tick,800,802,-2,2,149700,149300,13862,-37762,-38162,OK
140.989911,TraderOne,Tick,800,802,-2,2,149700,149300,13862,-37762,-38162,OK
141.227727,TraderOne,Tick,800,802,-2,2,149700,149300,13862,-37762,-38162,OK
141.524086,TraderOne,Tick,800,802,-2,2,149700,149300,13862,-37762,-38162,OK
141.771862,TraderOne,Tick,800,812,-12,12,150200,149500,13712,-38612,-41012,OK
141.966371,TraderOne,Tick,800,812,-12,12,150200,149500,13712,-38612,-41012,OK
142.292279,TraderOne,Tick,800,812,-12,12,150200,149500,13712,-38612,-41012,OK
142.532082,TraderOne,Tick,800,812,-12,12,150200,149500,13712,-38612,-41012,OK
142.794434,TraderOne,Tick,800,822,-22,22,150200,149500,13562,-37462,-41862,OK
143.008062,TraderOne,Tick,800,822,-22,22,150200,149500,13562,-37462,-41862,OK
143.231227,TraderOne,Tick,800,822,-22,22,150200,149500,13562,-37462,-41862,OK
143.496517,TraderOne,Tick,800,822,-22,22,150200,149700,13562,-37462,-41862,OK
143.721485,TraderOne,Tick,800,832,-32,32,150200,149700,13412,-35312,-41712,OK
144.040283,TraderOne,Tick,810,832,-22,22,149200,149700,13262,-38162,-33762,OK
144.233441,TraderOne,Tick,810,832,-22,22,149200,149700,13262,-38162,-33762,OK
144.549993,TraderOne,Tick,820,832,-12,12,149100,149700,13112,-40012,-37612,OK
144.736547,TraderOne,Tick,820,832,-12,12,149100,149700,13112,-40012,-37612,OK
145.035519,TraderOne,Tick,820,832,-12,12,149100,149700,13112,-40012,-37612,OK
145.221425,TraderOne,Tick,820,832,-12,12,149100,149700,13112,-40012,-37612,OK
145.500104,TraderOne,Tick,820,832,-12,12,149100,149700,13112,-40012,-37612,OK
145.750559,TraderOne,Tick,820,832,-12,12,149100,149700,13112,-40012,-37612,OK
145.994985,TraderOne,Tick,820,832,-12,12,149100,149700,13112,-40012,-37612,OK
146.278346,TraderOne,Tick,820,832,-12,12,149100,149500,13112,-40012,-37612,OK
146.521168,TraderOne,Tick,820,832,-12,12,149100,149500,13112,-40012,-37612,OK
146.773242,TraderOne,Tick,820,832,-12,12,149100,149700,13112,-40012,-37612,OK
147.042883,TraderOne,Tick,820,832,-12,12,149100,149700,13112,-40012,-37612,OK
147.213273,TraderOne,Tick,820,832,-12,12,149100,149700,13112,-40012,-37612,OK
147.525738,TraderOne,Tick,820,832,-12,12,149100,149600,13112,-40012,-37612,OK
147.730425,TraderOne,Tick,820,832,-12,12,149100,149600,13112,-40012,-37612,OK
147.978982,TraderOne,Tick,820,832,-12,12,149100,149600,13112,-40012,-37612,OK
148.29942,TraderOne,Tick,820,832,-12,12,149100,149600,13112,-40012,-37612,OK
148.469223,TraderOne,Tick,820,832,-12,12,149100,149600,13112,-40012,-37612,OK
148.761121,TraderOne,Tick,820,832,-12,12,149100,149600,13112,-40012,-37612,OK
149.024377,TraderOne,Tick,820,832,-12,12,149100,149600,13112,-40012,-37612,OK
149.215937,TraderOne,Tick,820,832,-12,12,149100,149600,13112,-40012,-37612,OK
149.537041,TraderOne,Tick,820,842,-22,22,150600,150100,12962,-36862,-43462,OK
149.723801,TraderOne,Tick,820,842,-22,22,150600,150100,12962,-36862,-43462,OK
150.027506,TraderOne,Tick,820,842,-22,22,150600,150100,12962,-36862,-43462,OK
150.216396,TraderOne,Tick,820,842,-22,22,150600,150100,12962,-36862,-43462,OK
150.491973,TraderOne,Tick,820,849,-29,29,150000,150100,13172,-35672,-32772,OK
150.791423,TraderOne,Tick,820,849,-29,29,150000,150100,13172,-35672,-32772,OK
150.987809,TraderOne,Tick,820,849,-29,29,150000,150100,13172,-35672,-32772,OK
151.206828,TraderOne,Tick,820,849,-29,29,150000,150100,13172,-35672,-32772,OK
151.477275,TraderOne,Tick,820,849,-29,29,150000,150100,13172,-35672,-32772,OK
151.767698,TraderOne,Tick,820,849,-29,29,150000,150100,13172,-35672,-32772,OK
152.004578,TraderOne,Tick,820,849,-29,29,150000,150100,13172,-35672,-32772,OK
152.223867,TraderOne,Tick,820,849,-29,29,150000,150100,13172,-35672,-32772,OK
152.468012,TraderOne,Tick,820,849,-29,29,150000,150100,13172,-35672,-32772,OK
152.793434,TraderOne,Tick,820,849,-29,29,150000,150100,13172,-35672,-32772,OK
153.002176,TraderOne,Tick,820,859,-39,39,150400,150100,13022,-33522,-45222,OK
153.257786,TraderOne,Tick,820,859,-39,39,150400,149800,13022,-33522,-45222,OK
153.482439,TraderOne,Tick,820,859,-39,39,150400,149800,13022,-33522,-45222,OK
153.799419,TraderOne,Tick,820,859,-39,39,150400,150100,13022,-33522,-45222,OK
154.037911,TraderOne,Tick,820,859,-39,39,150400,150100,13022,-33522,-45222,OK
154.210417,TraderOne,Tick,820,859,-39,39,150400,150100,13022,-33522,-45222,OK
154.502931,TraderOne,Tick,820,859,-39,39,150400,150100,13022,-33522,-45222,OK
154.759483,TraderOne,Tick,820,859,-39,39,150400,150100,13022,-33522,-45222,OK
155.049612,TraderOne,Tick,830,859,-29,29,150600,150100,13323,-36823,-45523,OK
155.292155,TraderOne,Tick,830,859,-29,29,150600,150100,13323,-36823,-45523,OK
155.464286,TraderOne,Tick,830,859,-29,29,150600,150300,13323,-36823,-45523,OK
155.789632,TraderOne,Tick,830,859,-29,29,150600,150300,13323,-36823,-45523,OK
155.99111,TraderOne,Tick,830,859,-29,29,150600,150300,13323,-36823,-45523,OK
156.292177,TraderOne,Tick,830,859,-29,29,150600,150300,13323,-36823,-45523,OK
156.465477,TraderOne,Tick,830,859,-29,29,150600,150300,13323,-36823,-45523,OK
156.740866,TraderOne,Tick,830,859,-29,29,150600,150300,13323,-36823,-45523,OK
156.980805,TraderOne,Tick,830,859,-29,29,150600,150300,13323,-36823,-45523,OK
157.211722,TraderOne,Tick,830,859,-29,29,150600,150300,13323,-36823,-45523,OK
157.523389,TraderOne,Tick,830,859,-29,29,150600,150300,13323,-36823,-45523,OK
157.758552,TraderOne,Tick,830,859,-29,29,150600,150300,13323,-36823,-45523,OK
157.971144,TraderOne,Tick,830,859,-29,29,150600,150300,13323,-36823,-45523,OK
158.237759,TraderOne,Tick,830,859,-29,29,150600,150300,13323,-36823,-45523,OK
158.496006,TraderOne,Tick,830,859,-29,29,150500,150300,13323,-36823,-42623,OK
158.722077,TraderOne,Tick,830,859,-29,29,150500,150300,13323,-36823,-42623,OK
159.003066,TraderOne,Tick,840,859,-19,19,150600,150400,13624,-39124,-42924,OK
159.262181,TraderOne,Tick,840,859,-19,19,150600,150400,13624,-39124,-42924,OK
159.547721,TraderOne,Tick,840,869,-29,29,150500,150400,13925,-38425,-41325,OK
159.708757,TraderOne,Tick,850,869,-19,19,150600,150400,14226,-40726,-44526,OK
160.048449,TraderOne,Tick,850,869,-19,19,150600,150400,14226,-40726,-44526,OK
160.205836,TraderOne,Tick,850,869,-19,19,150600,150400,14226,-40726,-44526,OK
160.519801,TraderOne,Tick,850,869,-19,19,150600,150400,14226,-40726,-44526,OK
160.797574,TraderOne,Tick,850,877,-27,27,150500,150200,14467,-40167,-48267,OK
161.004077,TraderOne,Tick,850,877,-27,27,150500,150200,14467,-40167,-48267,OK
161.219668,TraderOne,Tick,850,877,-27,27,150500,150200,14467,-40167,-48267,OK
161.501054,TraderOne,Tick,850,877,-27,27,150500,150200,14467,-40167,-48267,OK
161.794902,TraderOne,Tick,850,877,-27,27,150500,150200,14467,-40167,-48267,OK
161.997218,TraderOne,Tick,851,877,-26,26,150600,150200,14497,-40297,-48097,OK
162.218685,TraderOne,Tick,851,877,-26,26,150600,150700,14497,-40297,-37697,OK
162.546991,TraderOne,Tick,861,877,-16,16,150800,150800,14799,-41599,-41599,OK
162.747025,TraderOne,Tick,861,877,-16,16,150800,150700,14799,-41599,-43199,OK
163.005961,TraderOne,Tick,861,877,-16,16,150800,150700,14799,-41599,-43199,OK
163.293795,TraderOne,Tick,862,877,-15,15,150700,150600,14784,-41584,-43084,OK
163.527074,TraderOne,Tick,862,877,-15,15,150700,150800,14784,-41584,-40084,OK
163.748069,TraderOne,Tick,862,877,-15,15,150700,150800,14784,-41584,-40084,OK
163.965161,TraderOne,Tick,862,877,-15,15,150700,150800,14784,-41584,-40084,OK
164.246543,TraderOne,Tick,872,877,-5,5,151000,151000,15086,-42886,-42886,OK
164.527318,TraderOne,Tick,872,877,-5,5,151000,150900,15086,-42886,-43386,OK
164.751116,TraderOne,Tick,872,878,-6,6,151100,150900,15071,-42771,-43971,OK
164.959427,TraderOne,Tick,872,878,-6,6,151100,150900,15071,-42771,-43971,OK
165.225753,TraderOne,Tick,872,878,-6,6,151100,151000,15071,-42771,-43371,OK
165.48987,TraderOne,Tick,872,888,-16,16,151400,151000,14920,-42620,-47420,OK
165.73574,TraderOne,Tick,872,888,-16,16,151400,151000,14920,-42620,-47420,OK
165.958444,TraderOne,Tick,872,888,-16,16,151400,151000,14920,-42620,-47420,OK
166.280771,TraderOne,Tick,872,893,-21,21,151300,151100,14844,-41544,-45744,OK
166.471737,TraderOne,Tick,872,893,-21,21,151300,151100,14844,-41544,-45744,OK
166.705363,TraderOne,Tick,872,893,-21,21,151300,151100,14844,-41544,-45744,OK
167.017094,TraderOne,Tick,872,893,-21,21,151300,151100,14844,-41544,-45744,OK
167.299453,TraderOne,Tick,872,893,-21,21,151300,151100,14844,-41544,-45744,OK
167.538496,TraderOne,Tick,872,893,-21,21,151300,151100,14844,-41544,-45744,OK
167.793001,TraderOne,Tick,882,893,-11,11,151500,151100,15147,-44847,-48147,OK
168.008437,TraderOne,Tick,882,893,-11,11,151500,151100,15147,-44847,-48147,OK
168.290817,TraderOne,Tick,882,893,-11,11,151500,151100,15147,-44847,-48147,OK
168.458613,TraderOne,Tick,882,893,-11,11,151500,151100,15147,-44847,-48147,OK
168.756417,TraderOne,Tick,882,893,-11,11,151500,151100,15147,-44847,-48147,OK
169.010243,TraderOne,Tick,882,893,-11,11,151500,151100,15147,-44847,-48147,OK
169.282972,TraderOne,Tick,882,903,-21,21,151100,150500,14996,-43696,-49996,OK
169.534392,TraderOne,Tick,882,903,-21,21,151100,150500,14996,-43696,-49996,OK
169.800281,TraderOne,Tick,882,903,-21,21,151100,150800,14996,-43696,-49996,OK
169.966446,TraderOne,Tick,882,903,-21,21,151100,150700,14996,-43696,-49996,OK
170.21105,TraderOne,Tick,882,903,-21,21,151100,150700,14996,-43696,-49996,OK
170.50273,TraderOne,Tick,882,903,-21,21,151100,150700,14996,-43696,-49996,OK
170.790423,TraderOne,Tick,882,903,-21,21,151100,150500,14996,-43696,-49996,OK
171.00558,TraderOne,Tick,882,903,-21,21,151100,150500,14996,-43696,-49996,OK
171.267511,TraderOne,Tick,882,903,-21,21,151100,150500,14996,-43696,-49996,OK
171.539758,TraderOne,Tick,886,903,-17,17,150600,150500,14936,-44036,-45736,OK
171.722958,TraderOne,Tick,886,903,-17,17,150600,150500,14936,-44036,-45736,OK
171.97671,TraderOne,Tick,892,913,-21,21,151200,150500,14695,-43395,-49695,OK
172.288637,TraderOne,Tick,892,913,-21,21,151200,150500,14695,-43395,-49695,OK
172.491405,TraderOne,Tick,892,913,-21,21,151200,150500,14695,-43395,-49695,OK
172.760855,TraderOne,Tick,892,923,-31,31,151000,150500,14544,-41244,-50544,OK
173.033011,TraderOne,Tick,892,923,-31,31,151000,150500,14544,-41244,-50544,OK
173.240066,TraderOne,Tick,892,923,-31,31,151000,150500,14544,-41244,-50544,OK
173.505809,TraderOne,Tick,892,923,-31,31,151000,150500,14544,-41244,-50544,OK
173.769201,TraderOne,Tick,892,923,-31,31,151000,150500,14544,-41244,-50544,OK
174.033317,TraderOne,Tick,892,923,-31,31,151000,150500,14544,-41244,-50544,OK
174.245277,TraderOne,Tick,892,923,-31,31,151000,150500,14544,-41244,-50544,OK
174.464694,TraderOne,Tick,892,923,-31,31,151000,150500,14544,-41244,-50544,OK
174.753307,TraderOne,Tick,892,923,-31,31,151000,150600,14544,-41244,-50544,OK
174.995396,TraderOne,Tick,902,923,-21,21,150800,150600,14846,-43546,-47746,OK
175.203941,TraderOne,Tick,912,923,-11,11,150800,150600,15148,-45848,-48048,OK
175.495767,TraderOne,Tick,912,923,-11,11,150800,150600,15148,-45848,-48048,OK
175.794202,TraderOne,Tick,912,923,-11,11,150800,150600,15148,-45848,-48048,OK
176.042715,TraderOne,Tick,912,923,-11,11,150800,150600,15148,-45848,-48048,OK
176.272554,TraderOne,Tick,912,923,-11,11,150800,150600,15148,-45848,-48048,OK
